##########
#.....@..#
#........#
#........#
##########
