##########
#........###################
#..........................#
#........#################.#
##########               #.#
                         #.#
                         #.#
                         #.#
                         #.#
                         #.#
                         #.##############################################
                         #..............................................#
                         #..............................................#
                         #..............................................#
                         #........................................@.....#
                         #..............................................#
                         #..............................................#
                         #..............................................#
                         #..............................................#
                         ################################################
